#############
# W a #     #
### ##### ###
# M a r i a #
#############