#####################
# #         #   #   #
# # ### ##### ### # #
#     #           # #
##### # ### ### #####
#   # #   #   # #   #
# ### ##### # ##### #
# # #   #   #     # #
# # # # # ####### # #
#   # # # #     #   #
### ##### # #########
#           #   # # #
# ##### # ### ### # #
#     # #     #     #
####### # ######### #
# #   # # #         #
# ### # # # ####### #
#     # # # #   # # #
##### # # # # # # # #
#     # # # # #   # #
# ##### ### ##### # #
#             #   # #
##### # ### # # # # #
#     #   # #   # # #
#####################